R 1024 768
NO ./srcs/1.xpm
SO ./srcs/2.xpm
WE ./srcs/25.xpm
EA ./srcs/15.xpm
S ./srcs/3.xpm
F 12,12,12
C 32,56,100
     111111111111111
     122200002222221
     122200000202021
11111100000000000011
10000021000S0000001
1002000000100002001
1000000000000000001
1000000200000100001
1000000001000200001
1001002000000000001
1000000011111111111
111100001
   100011
   11111
